
SO  ggg.xpm
NO ggg.xpm
WE ggg.xpm
EA ggg.xpm

C 0,126,5
F 225,9,10

111111111111111
100001000000001
10000111111111111111111111
1000001100N000000000010001
10000000000000000000000001
10000011000000000000010001
11101111111011111111110001
110000110000001      10001
100000010000001      10001
100000010000001      10001
1000000000000011111111101111111111
10000001000000100000000000000000001
100000010000001000000000000000000011111
110000110000001001100000000000110010001
111111111111111001000000000000010010001
              1000000000000000000010001
              1000000000000000000010001
              1000000000000000000000001
              1000000000000000000010001
              1000000000000000000010001
              1001000000000000010010001
              1001100000000000110010001
              1000000000000000000010001
              1000000000000000000010001
              1111111111111111111110001
                                  10001
                                  11111