EA textures//1.png
WE textures//22.png
SO textures//333.png
NO textures//222.png

C 1,126,00000
F 225,90,0


111111111111111111111111111111111111111111111111111111111111
100000000000000000000000000000000000000000000000000000000001
100000000000000000000000000000000000000000000000000000000001
100001111111111111111111111111111111000000000000000000000001
100000000000000000000000000000000000000000000000000000000001
100000000000000000000000000000001111111111111111111111111111
100000000000000000000000000000000000000000000000000000000001
100001111111111111111111111111111111000000000000000000000001
100000000000000000000000000000000000000000000000000000000001
100000000000000000000000000000001111111111111111111111111111
100000000000000000000000000000000000000000000000000000000001
100001111111111111111111111111111111000000000000000000000001
1000000000000000000000000000000000000000000000000000000000W1
100000000000000000000000000000001111111111111111111111111111
100000000000000000000000000000000000000000000000000000000001
100001111111111111111111111111111111000000000000000000000001
100000000000000000000000000000000000000000000000000000000001
100000000000000000000000000000001111111111111111111111111111
100000000000000000000000000000000000000000000000000000000001
100000000000000000000000000000000000000000000000000000000001
111111111111111111111111111111111111111111111111111111111111