EA Textures/1.png
WE Textures/2.png

C 1,126,00000
F 225,90,0

SO Textures/3.png
NO Textures/4.png

111111111111111111111111111111
100000000000000000000000010001
100000000000000000000000000001
100000000000000000000000010001
100000000000000000000000000001
100000000000000000000000000001
100000000000000000000000000001
100000000000000000000000000001
100000000000000N00000000000001
100000000000000000000000000001
100000000000000000000000000001
100000000000000000000000000001
100000000000000000000000000001
100000000000000000000000000001
100000000000000000000000000001
100000000000000000000000000001
100000000000000000000000000001
111111111111111111111111111111