EA Textures/ggg.xpm
WE Textures//ggg.xpm
SO Textures//ggg.xpm
NO Textures//ggg.xpm

C 1,126,00000
F 225,90,0

111111111111111
100000000000001
10111111111011111111111111
10000010000000000000010001
10000000000000000000000001
10000010000000000000010001
11101111111011111111110001
110000110000001      10001
100000010000001      10001
100000010000001      10001
10000000000000111111111011111111111
10000001000000000000000000000000001
100000010000001000000000000000000011111
110000110000001001100000000000110010001
111111111111111001000000000000010010001
              1000000000000000000010001
              1000000000000000000010001
              1000000000000000000000001
              1000000000000000000010001
              1000000000000000000010001
              1001000000000000010010001
              1001100000000000110010001
              1000000000000000000010001
              1000000000000000000010001
              1111111111111111111110001
                                  10S01
                                  11111
