EA Textures/ggg.xpm
WE Textures/ggg.xpm
SO Textures//ggg.xpm
NO Textures//ggg.xpm

C 1,126,00000
F 225,90,0


11111111111111111111111111111111111       1111111111111111111111111
        1000000000110000000000001        10000000110000010000001
        111000001110000000000001         100000001110000010000001
        1001000000000000000000001        1000000000000000000000001
11111111101100000101000001000000111111111101100011110000010000001
1000000000110000011111011111111111  100000000011000001111111111111111
1111011111111111110000001000111110111101011110000000100011
1111011111111101110101000000111110111111111011001010000001
110000001101010111100000100000000000110101011110000010001
100000001000000011000001000111100000001000000010000001000111
1000000000000000110101001000110000000000000001101010010001
110000011101010111111111100111000001110101011111011110011
11111111 101000000000001111111111111 101111100000001111
111111111111111111111111           111111111111111101111111
1000000000000000000000001          1000000000110000010000001
1011000001110000000000001         1011000001110000010000001
10010000000000000000000011111111   10010000000000000000001111111
11111111111000001010000000000001111111111011100001010000010000001
100000000011000001111101111111111100000000011000001111101111111111
11110111111111111100000010001111100111111111011100000010001
1111011111111101110101000000111110111111111011101010000001
1100000011010101111000001000111000000110101011110000010001
1000000010000000110000100000000000001000000011000001000111
1000000000000000110101001000110000000000000001101010010001
11000001110101011111011110011100S001110101011111011110011
11111111 101111111111111111111111111 1011111111111111111
       11111 1                    111111    111111  1